1111111111111
1  1       C1
1    11111  1
1P  11E     1
1111111111111