111111111111111111111111
10000000000000MC00000001
1M1001010010000010110101
1E1001001010101000110101
100000000C00C000000000C1
100000000C00C000000000C1
100000000CMMC000000000C1
100000000C00C000000000C1
100000000C00C0000M0000C1
101000000111100001111111
1P1000000100100001000C01
10000000010010000M000001
100000000000000000000011
111111111111111111111111
