111111111111111111111111
1P1000000000000C00000001
101001010010000010110101
101001001010101000110101
101000000C00C000000000C1
101000000MMMM00001111111
101000000ME0M00000000C01
100000000M00M00001000001
111111111111111111111111
