111111111111111111111111
101000000000000C00000001
1P1001010010000010110101
101001001010101000110101
101000000C00C000000000C1
101000000MMMM00001111111
101000000M00M00001000C01
1E0000000M00M00001000001
111111111111111111111111
